able	có năng lực, có tài
abandon	bỏ, từ bỏ
about	khoảng, về;
above	ở trên, lên trên;
act	hành động, hành vi, cử chỉ, đối xử;
add	cộng, thêm vào;
afraid	sợ, sợ hãi, hoảng sợ;
after	sau, đằng sau, sau khi;
again	lại, nữa, lần nữa;
against	chống lại, phản đối;
age	tuổi;
ago	trước đây;
agree	đồng ý, tán thành;
air	không khí, bầu không khí, không gian;
all	tất cả;
allow	cho phép, để cho;
also	cũng, cũng vậy, cũng thế;
always	luôn luôn;
among	giữa, ở giữa;
an	(tiếng địa phương) nếu;
and	và;
anger	sự tức giận, sự giận dữ;
animal	động vật, thú vật;
answer	sự trả lời; trả lời;
any	một người, vật nào đó; bất cứ; một chút nào, tí nào;
appear	xuất hiện, hiện ra, trình diện;
apple	quả táo;
are	A(đơn vị diện tích ruộng đất, bằng 100m2);
area	diện tích, bề mặt;
arm	cánh tay; vũ trang, trang bị (vũ khí);
arrange	sắp xếp, sắp đặt, sửa soạn;
arrive	đến, tới nơi;
art	nghệ thuật, mỹ thuật;
as	như (as you know…);
ask	hỏi;
at	ở tại (chỉ vị trí);
atom	nguyên tử;
baby	đứa bé mới sinh; trẻ thơ;
back	lưng, về phía sau, trở lại;
bad	xấu, tồi;
ball	quả bóng;
band	băng, đai, nẹp;
bank	bờ (sông…), đê;
bar	quán bán rượu;
base	cơ sở, cơ bản, nền móng; đặt tên, đặt cơ sở trên cái gì;
basic	cơ bản, cơ sở;
bat	(thể dục,thể thao) gây (đánh bóng chày, crikê); (từ cổ,nghĩa cổ) vợt (quần vợt);
be	thì, là;
bear	mang, cầm, vác, đeo, ôm;
beat	tiếng đập, sự đập; đánh đập, đấm;
beauty	vẻ đẹp, cái đẹp; người đẹp;
bed	cái giường;
been	thì, là;
before	trước, đằng trước;
began	bắt đầu, mở đầu, khởi đầu;
begin	bắt đầu, khởi đầu;
behind	sau, ở đằng sau;
believe	tin, tin tưởng;
bell	cái chuông, tiếng chuông;
best	tốt nhất;
better	tốt hơn;
between	giữa, ở giữa;
big	to, lớn;
bird	chim;
bit	miếng, mảnh;
black	đen; màu đen;
block	khối, tảng (đá); làm ngăn cản, ngăn chặn;
blood	máu, huyết; sự tàn sát, chem giết;
blow	nở hoa; sự nở hoa;
blue	xanh, màu xanh;
board	tấm ván; lát ván, lót ván;
boat	tàu, thuyền;
body	thân thể, thân xác;
bone	xương;
book	sách; ghi chép;
born	sinh, đẻ;
both	cả hai;
bottom	phần dưới cùng, thấp nhất; cuối, cuối cùng;
bought	mua;
box	hộp, thùng;
boy	con trai, thiếu niên;
branch	ngành; nhành cây, nhánh song, ngả đường;
bread	bánh mỳ;
break	bẻ gãy, đập vỡ; sự gãy, sự vỡ;
bright	sáng, sáng chói;
bring	mang, cầm, xách lại;
broad	rộng;
broke	khánh kiệt, túng quẫn, bần cùng;
brother	anh, em trai;
brought	cầm lại, đem lại, mang lại, xách lại, đưa lại;
brown	nâu, màu nâu;
build	xây dựng;
burn	đốt, đốt cháy, thắp, nung, thiêu;
busy	bận, bận rộn;
but	nhưng;
buy	mua;
by	bởi, bằng; 
call	gọi; tiếng kêu, tiếng gọi;
came	khung chì (để) lắp kinh (cửa);
camp	trại, chỗ cắm trại; cắm trại, hạ trại;
can	có thể; nhà tù, nhà giam, bình, ca đựng;
capital	thủ đô, tiền vốn; chủ yếu, chính yếu, cơ bản;
captain	người cầm đầu, người chỉ huy, thủ lĩnh;
car	xe hơi;
card	thẻ, thiếp;
care	sự chăm sóc, chăm nom; chăm sóc;
carry	mang, vác, khuân chở;
case	vỏ, ngăn, túi;
cat	con mèo;
catch	bắt lấy, nắm lấy, tóm lấy, chộp lấy;
caught	sự bắt, sự nắm lấy; cái bắt, cái vồ, cái chộp;
cause	nguyên nhân, nguyên do; gây ra, gây nên;
cell	ô, ngăn;
cent	đồng xu (=1/100 đô la);
center	(từ Mỹ,nghĩa Mỹ) (như) centre;
century	thế kỷ;
certain	chắc chắn;
chair	ghế;
chance	sự may mắn;
change	thay đổi, sự thay đổi, sự biến đổi;
character	tính cách, đặc tính, nhân vật;
charge	nhiệm vụ, bổn phận, trách nhiệm; giao nhiệm vụ, giao việc;
chart	đồ thị, biểu đồ; vẽ đồ thị, lập biểu đồ;
check	kiểm tra; sự kiểm tra;
chick	gà con; chim con;
chief	trọng yếu, chính yếu; thủ lĩnh, lãnh tụ, người đứng đầu, xếp;
child	đứa bé, đứa trẻ;
children	đứa bé, đứa trẻ;
choose	chọn, lựa chọn;
chord	dây (đàn hạc);
circle	đường tròn, hình tròn;
city	thành phố;
claim	đòi hỏi, yêu sách; sự đòi hỏi, sự yêu sách, sự thỉnh cầu;
class	lớp học;
clean	sạch, sạch sẽ;;
clear	lau chùi, quét dọn;
climb	leo, trèo;
clock	đồng hồ;
close	đóng kín, chật chội, che đậy, đóng, khép, kết thúc, chấm dứt;
clothe	mặc quần áo cho;
cloud	mây, đám mây;
coast	sự lao dốc; bờ biển;
coat	áo choàng;
cold	lạnh, sự lạnh lẽo, lạnh nhạt;
collect	sưu tập, tập trung lại;
colony	thuộc địa;
color	(từ Mỹ,nghĩa Mỹ) (như) colour;
column	cột, mục (báo);
come	đến, tới, đi đến, đi tới;
common	công, công cộng, thông thường, phổ biến;
company	công ty;
compare	so sánh, đối chiếu;
complete	hoàn thành, xong;;
condition	điều kiện, tình cảnh, tình thế;
connect	kết nối, nối;
consider	cân nhắc, xem xét; để ý, quan tâm, lưu ý đến;
consonant	(âm nhạc) thuận tai, êm ái, du dương;
contain	bao hàm, chứa đựng, bao gồm;
continent	lục địa, đại lục (lục địa Bắc Mỹ);
continue	tiếp tục, làm tiếp;
control	sự điều khiển, quyền hành, quyền lực, quyền chỉ huy;
cook	nấu ăn, người nấu ăn;
cool	mát mẻ, điềm tĩnh; làm mát;
copy	bản sao, bản chép lại; sự sao chép; sao chép, bắt chước;
corn	chai (chân);
corner	góc (tường, nhà, phố...);
correct	đúng, chính xác; sửa, sửa chữa;
cost	giá, chi phí; trả giá, phải trả;
cotton	bông, chỉ, sợi;
could	có thể, có khả năng;
count	đếm, tính;
country	nước, quốc gia, đất nước;
course	tiến trình, quá trình diễn tiến; sân chạy đua;
cover	bao bọc, che phủ; vỏ, vỏ bọc;
cow	con bò cái;
crease	nếp nhăn, nếp gấp;
create	sáng tạo, tạo nên;
crop	vụ mùa;
cross	cây Thánh Giá, nỗi thống khổ; sự băng qua; băng qua, vượt qua;
crowd	đám đông;
cry	khóc, kêu la; sự khóc, tiếng khóc, sự kêu la;
current	hiện hành, phổ biến, hiện nay; dòng (nước), luống (gió);
cut	cắt, chặt; sự cắt;
dad	bố, cha;
dance	sự nhảy múa, sự khiêu vũ; nhảy múa, khiêu vũ;
danger	sự nguy hiểm, mối hiểm nghèo; nguy cơ, mối đe dọa;
dark	tối, tối tăm; bóng tối, ám muội;
day	ngày, ban ngày;
dead	chết, tắt;
deal	phân phát, phân phối; sự giao dịch, thỏa thuận mua bán;
dear	thân, thân yêu, thân mến; kính thưa, thưa;
death	sự chết, cái chết;
decide	quyết định, giải quyết, phân xử;
decimal	thập phân;
deep	sâu, khó lường, bí ẩn;
degree	mức độ, trình độ; bằng cấp; độ;
depend	(+ on, upon) phụ thuộc, tuỳ thuộc, tuỳ thuộc;
describe	diễn tả, miêu tả, mô tả;
desert	sa mạc; công lao, giá trị; rời bỏ, bỏ trốn;
design	sự thiết kế, kế hoạch, đề cương. phác thảo; phác họa, thiết kế;
determine	xác định, định rõ; quyết định;
develop	phát triển, mở rộng; trình bày, bày tỏ;
dictionary	từ điển;
die	chết, từ trần, hy sinh;
differ	khác, không giống;
difficult	khó, khó khăn, gay go;
direct	trực tiếp, thẳng, thẳng thắn; gửi, viết cho ai, điều khiển;
discuss	thảo luận, tranh luận;
distant	xa, cách, xa cách;
divide	chia, chia ra, phân ra;
division	sự chia, sự phân chia, sự phân loại;
do	làm, làm;
doctor	bác sĩ y khoa, tiến sĩ;
does	hươu cái, hoãng cái; nai cái;
dog	chó;
dollar	đô la Mỹ;
done	xong, hoàn thành, đã thực hiện;
door	cửa, cửa ra vào;
double	đôi, hai, kép; cái gấp đôi, lượng gấp đôi; làm gấp đôi;
down	xuống;
draw	vẽ, kéo;
dream	giấc mơ, mơ;
dress	quần áo, mặc (quần áo), ăn mặc;
drink	đồ uống; uống;
drive	lái, đua xe; cuộc đua xe (điều khiển);
drop	chảy nhỏ giọt, rơi, rớt; giọt (nước, máu...);
dry	khô, cạn; làm khô, sấy khô;
duck	con vịt, vịt cái;
during	trong lúc, trong thời gian;